title Escape 1
goalcount 26
pattern C,A,C,A,B
block
        D | A | B | B | C | A | B | C,$ |
        D | C | A | C | A | B | C | B |
        D | B | A | A | C | B | A | C |
        D | C | C | B |   | A | C | A |
        D | A | B | C | B | C | B | B |
        D | C | A | C | C | A | A | C |
      D | ^,* | C | B | A | C | B | A |
